1111111111111111111111111111111111
1000000000000000000000000000000001
1110000000000000000000000000000001
1110000000001111100000000000001111
1000000110000000000011000011000001
1000000000000001110000000000000001
1111100000000000000000000000000001
1000000000001111000010001000010101
1000000000000000000000000000000001
1110000000000000000000000000000001
1110000000001111100000000000001111
1000000110000000000011000011000001
1000000000000001110000000000000001
1111100000000000000000000000000001
1000000000001111000010001000010101
1000000000000000000000000000000001
1110000000000000000000000000000001
1110000000001111100000000000001111
1000000110000000000011000011000001
1000000000000001110000000000000001
1111100000000000000000000000000001
1000000000001111000010001000010101
1000000000000000000000000000000001
1110000000000000000000000000000001
1110000000001111100000000000001111
1000000110000000000011000011000001
1000000000000001110000000000000001
1111100000000000000000000000000001
1000000000001111000010001000010101
1000000000000000000000000000000001
1110000000000000000000000000000001
1110000000001111100000000000001111
1000000110000000000011000011000001
1000000000000001110000000000000001
1111100000000000000000000000000001
1000000000001111000010001000010101
1111111111111111111111111111111111